# The ASF licenses this file to You under the Apache License, Version 2.0
# (the "License"); you may not use this file except in compliance with
# the License.  You may obtain a copy of the License at
#
#     http://www.apache.org/licenses/LICENSE-2.0
#
# Unless required by applicable law or agreed to in writing, software
# distributed under the License is distributed on an "AS IS" BASIS,
# WITHOUT WARRANTIES OR CONDITIONS OF ANY KIND, either express or implied.
# See the License for the specific language governing permissions and
# limitations under the License.

#-----------------------------------------------------------------------
#some test synonym mappings unlikely to appear in real input text
aaafoo => aaabar
bbbfoo => bbbfoo bbbbar
cccfoo => cccbar cccbaz
fooaaa=>baraaa,bazaaa

# Some synonym groups specific to this example
GB=>gib,gigabyte,gigabytes
MB=>mib,megabyte,megabytes
Television=> Televisions, TV, TVs
#notice we use "gib" instead of "GiB" so any WordDelimiterFilter coming
#after us won't split it into two words.

# Synonym mappings can be used for spelling correction too
pixima => pixma

# manually added
EF=>LVEF,ejection fraction,left ventricular ejection fraction
hx=>history
cxr=>chest x-ray

# manually transcribed from SDC Test vitals synonyms files(120.51) on 2/5/2014.
ag=>abdominal girth
aud=>audiometry
bp=>blood pressure
cvp=>central venous pressure
cg=>circumference/girth
ft=>fetal heart tones
fh=>fundal height
hc=>head circumference
he=>hearing
ht=>height
pn=>pain
p=>pulse
po2=>pulse oximetry
r=>respiration
t=>temperature
ton=>tonometry
vc=>vision corrected
vu=>vision uncorrected
wt=>weight

# Generated from dev account on (11/4/2013) using Unit test in LuceneSearchDataSourceTests.generateSynonymnList()
1\=>25-dihydroxyvit d,vitimin d 1\,25 oh
11-deoxycortisol=>compound s
17-hydroxycorticosteroids=>porter silber
25 oh vitamin d=>vitamin d 25 0h
abo/rh typing=>abo group/rh type
act (ancillary test)=>activated coagulation time,activated clotting time
acth=>corticotropin
afb culture & smear=>tb culture & smear
afb smear direct=>tb smear
aglucose=>astra glucose,stat glucose
alcohol profile=>alcohols
alkaline phosphatase=>alk. phosphatase
alpha-1-antitrypsin=>alpha 1-antitrypsin
alt=>sgpt,alanine aminotransferase,alt
amikacin=>amik
amitriptyline & nortriptyline=>a&n,amy
ammonia=>nh3
amylase=>amy
ana=>antinuclear antibody
anaerobic culture=>ana.
angiotensin-1=>angiotensin-1-conv
antithrombin iii=>at iii
appearance=>app,uapp
astra glucose=>fbs
basic metabolic panel=>metabolic panel
basophil abs.=>baso abs
bath test\=> peak,btp
bath test\=> trough,btt
bicarbonate (hco3)=>hco3
bleeding time=>bt
blood culture set #1=>bc
blood culture set #2=>bc2
blood gases=>gas
bromide=>br
bronx problem test=>bpt,b.p.t.,bronx
bronx test=>btst
c difficile culture/toxin=>clostridium difficile culture/toxin,clostridium difficile culture/toxin
c-acid phos=>acid
c-reactive protein=>crp
c-reactive protein\=> high sensitivity,hs crp,high sensitivity c-reactive protein
c.difficile (buffalo)=>cdf
calcium=>ca
calculus=>stone
carbamazepine=>tegretol
cardiac enzymes=>pg
catecholamines\=> total,tcat
cbc & diff (with morphology)=>neb-cbc
cbc & differential=>blood count,diff
cea=>carcinoembryonic antigen
chem 10=>renal panel
chem 20=>c20
chem 7=>sma 6
chlordiazepoxide=>librium
chloride=>cl
cie: clostridium difficile=>c-difficile toxin
cie: group b streptococcus=>strep b
cie: meningococcus=>n-meng
cie: pneumococcus=>pneumo
ck-mb percent=>ck-mb %,percent cpk-mb
co2=>carbon dioxide
co2ct. (tco2)=>tco2
coag profile=>ptt & pt,pt/ptt
complement c2=>c2
complement c3=>c3
complement c4=>c4
complement c5=>c5
complement ch50=>total complement ch50
comprehensive metabolic panel=>cmp,metabolic
coombs\=> direct/indirect,direct/indirect ahg test
copper=>cu
cortisol=>compound f
cpk profile=>ck profile
cpk-mb=>mb
culture & susceptibility=>cult,c/s
culture\=> viral (send out),virus culture
cytology=>histology
cytology request=>cytology exam
d-dimer=>thrombosis
desipramine=>dmi
diazepam=>valium
differential count=>diff
differential count (new 5/24/2012)=>diff
dilantin=>phenytoin
dir. bilirubin=>d bili
disopyramide=>norpace
doxepin=>sinequan
drug screen (blood)=>tox screen (blood)
drug screen (urine)=>drugs of abuse,urine drug screen,tox screen (urine)
elisa for hiv=>hiv
epith cells=>epis,epithelial cells
estimated plts=>platelets estimated
fibrin split products=>fsp
fluid chemistries=>fluid tests,chemistry fluids
fluid chemistries=>chemistry fluids,fluid tests
folate=>folic acid
folate rbc w/hct=>rbc folate
folate\=> hemolysate,hemolysate folate
folate\=> rbc,rbc folate
free t-4=>free thyroxine
free triiodothyronine=>t-3\,free
gc culture=>gc
glucose=>sugar,blood sugar
glucose tolerance test=>gtt
glucose\=> other,blood sugar,dextrose
gtt\=>blood,gtt\,b,blood gtt
gtt\=>urine,gtt\,u,urine gtt
hcg=>human chorionic gonadotropin,pregnancy test,preg,beta hcg,bhcg,urine hcg\,qual
hcg beta\=> quant.,b-hcg
hemoglobin a1c=>hgba1c
heparin anti xa=>factor xa (heparin level),anti-xa heparin level,factor xa unfractionated
hepatitis a (total) igm/igg (immunity)=>hep a total
hepatitis a antibody=>havab
hepatitis b core antibody=>abhbc
hepatitis b screen=>anti-hav\, igm,ledi hep b screen
hepatitis b surface antibody=>abhbs
hepatitis b surface antigen=>hbsag
hepatitis e antibody=>heab
hepatitis e antigen=>heag
hgb=>hemoglobin
hgb & hct=>h&h,hgb&hct,h & h
homovanillic acid=>hva
hpv dna=>human papilloma virus
hypersegmented neutrophils=>pmn's
iga=>iga
igg=>igg
igm=>igm
imipramine=>imi
immunoelectrophoresis=>immuno
immunoglobulins=>immunos
india ink prep=>india ink
inr=>pt inr,pt-inr
iron=>fe
kglucose=>routine glucose,kda glucose
lactic acid=>lactate
ldh profile=>ld pro
ldl cholesterol (direct)=>direct ldl cholesterol
lead=>pb
legionella culture=>leg cul
legionella dfa=>leg dfa
leukocyte esterase\=> urine,ur leuk,urine leukocyte esterase
lipids\=> qualitative,qualitative fats
lithium=>li
liver function test=>liver profile,lft
lytes=>electrolytes,lytes
magnesium=>mg
manganese=>mn
mercury=>heavy metal
metanephrines\=> tot,menephs
mi test panel=>mi test
micro albumin=>urine albumin,albumin,microalbumin,csf albumin
microalbumin/creatinine ratio=>m/c
microbiology test list=>micro
misc maryland=>miscellaneous,catchall,anything
monocyte %=>monocyte\,alternate
mpv=>c
mrsa survl nares dna=>mrsa pcr,mrsa dna
mycology culture=>fungus culture
mysoline=>primidone
n-acetyl procainamide=>napa
neutrophil %=>neut %,granulocyte\,alternate
neutrophil\=> abs.,granulocytes\, absolute
nucleated rbc/100wbc=>nrbc/100 wbc
occult blood x3=>fobt
occult blood1=>fobt
occult blood2=>fobt
osmolarity=>osmolality
p1 profile 1=>sma i
p2 profile 2=>sma 12
pas with diastase stain=>diastase
pathology surgical tissue request=>pathology tissue exam,tissue request surgical pathology,surgical pathology tissue exam
pbnp=>bnp,natriuretic peptide brain
per cent ld1=>%ld1
ph =>ph
platelet aggregation=>plt
platelet count=>plt
plt (estm)=>plt
po4=>phosphorus
potassium=>k
procainamide=>pronestyl
profile 3 (routine)=>sma 6,pro 3,p3
profile 3 (stat)=>p3
pros=>promyelocytes
prostate specific antigen=>psa,ledipsa
prosthetic specific antigen=>psa,ledi psa
protamine sulfate=>3p
protein\=>total,total protein
protime=>prothrombin,prothrombim time,pt
pt/inr=>inr,pt
pth (intact)=>npth
ptt=>partial thromboplastin time
quantitative rheumatoid factor=>qrf
quantitative rheumatoid factor=>qrf
rbc=>red count,red blood count
renin=>angiotensin1
reticulocytes=>retic,retic count
rheumatoid factor=>rf
selenium=>se
sgot=>ast
sodium=>na
specific gravity=>usg
sterility test=>autoclave sterility testing\, bact,autoclave sterility testing\, bact,spore strip
strep a rapid=>group a streptococcus,strep,streptococcus,throat,beta hemolytic
sugar water test=>sucrose hemolysis
t-3 ru=>t-3 resin uptake,t3 resin uptake,t3ru
t-4=>thyroxine
t-4 binding globulin=>tbg
test5=>t5
theophylline=>aminophylline
thrombin time=>tt
tibc=>total iron-binding
tobramycin=>tobra
tot. bilirubin=>bilirubin\,total,tbil,t bil,tbili,t.bili,total bilirubin
tox screen\=> urine,urine tox screen,uts
transfusion request=>xmatch,x match,crossmatch
transfusion request\=> pre-op,pre-op crossmatch,xmatch\,pre-op,xmatch\,preop,preop crossmatch,preop xmatch
tri cyclic acid=>tca
triglyceride=>trigs
triiodothyronine=>t3 ria
triiodothyronine\=> total,t3,total,t-3
tsh=>thyroid stimulating hormone
type & hold=>t&h,t & h
type & screen=>t&s,t & s
uibc=>unsaturated iron binding capacity,unsaturated iron binding capacity
urea nitrogen=>bun,blood urea nitrogen,urea nitrogen\, blood
urinalysis=>ua
urinalysis (with micro)=>ua
urine 5hiaa=>5hiaa
urine bacteria=>ubac
urine bilirubin=>ubili
urine blood=>ubld
urine casts=>ucas
urine color=>ucol
urine crystals=>ucry
urine epith cells=>uepi
urine glucose=>uglu
urine hemosiderin=>hemosiderin
urine ketones=>uket
urine mucus=>umuc
urine ph=>ph,uph
urine protein=>upro
urine rbc casts=>ucas
urine rbc/hpf=>urbc
urine wbc casts=>uwcas
urine wbc/hpf=>uwbc
urine yeast=>yea
viral cx final report=>viral culture
vitamin b-12=>b 12,b-12,b12
vitamin d 25 (vamc)=>hydroxy vitamin d,25-oh vit d,vit d
wbc=>white blood count,white count
westergren sed rate=>esr,sed rate
wintrobe*=>esr
yersinia culture=>yersinia
zglucose*=>glu
zinc=>zn
zz abcdefghijklmnopqrstuvwxyz (123)=>abcdefghijklmnopqrstuvwxyz (abc)
zz abcdefghijklmnopqrstuvwxyz (123456)=>test567890 234567890 t3456789o abcdefxx,abcedfghijklmnopqrstuvwxyz (abcdefg),abcdefghijklmno,testitagainsam,abcdefghijklmnopqrstuvwxyz (1234)
zz not used 2=>skogee nois
zz urine epith total=>tot epi
zzdirect ldl=>dldl,ldl direct
zzjeanie(glucose panel)=>zjms
zzuric acid=>ua
zzurobilinogen=>uuro